111111111111111111111
100000000000000000001
100100000000000000001
100000S00000000000001
100000000000000111111
11111111000011111111111111111111
1000000000001001
1001000000001001
1000000000001001
1000000000001001
11110001111111111111111111111111
1000000000000001
1001000000000001
1000000000000001
1000000000000001
1111111111111111